05 02 00 04 01 00 02 05
03 03 03 03 03 03 03 03
12 12 12 12 12 12 12 12
12 12 12 12 12 12 12 12
12 12 12 12 12 12 12 12
12 12 12 12 12 12 12 12
09 09 09 09 09 09 09 09
11 08 06 10 07 06 08 11